22222222222
20011011112
20202021202
20001110002
21212021202
20000011112
20202120212
20011010012
20212021212
21101000102
22222222222
